
C 100,100,100
R 1200 1000
F 50,50,50

S ./sprites/star_ship.xpm

NO ./textures/space.xpm

SO ./textures/venus.xpm

WE ./textures/moon.xpm

EA ./textures/mars.xpm


11111111                  
10000001                  
11011101
 1011101111111111111111111
 1N00002000110000000000001
 1011000000111000000000001
 100100000000000000000001
1111111111111111111111111